
  @@@@     @     @    @@@   @@@    @@@@     @
 @    @    @     @    @  @ @  @   @    @   @
@      @   @     @    @   @   @   @     @@@
@      @   @     @    @   @   @   @@@@
@      @   @     @    @       @   @     @@@
 @    @    @          @       @   @    @   @
  @@@@     @@@@@@@    @       @    @@@@     @
  
wwwwwwwwwwwwwwwwwwwwwwwwwwwwwwwwwwwwwwwwwwwww  
